maze_name=10x10,level=2
0,1,1,1,1,1,0,1,0,1
8,0,0,0,0,0,0,1,0,0
0,1,1,1,1,1,0,1,1,0
0,1,0,0,0,0,0,0,0,0
0,1,0,1,1,1,1,1,0,1
0,0,0,1,3,0,0,0,0,0
1,1,0,1,1,1,0,1,1,1
1,0,0,0,0,0,0,1,0,0
1,0,1,1,1,0,1,1,0,1
1,0,0,0,0,0,0,0,0,0

maze_name=5x5,level=1
0,1,1,1,1
8,0,0,1,0
1,1,0,1,3
0,0,0,0,0
0,1,0,1,1
