Maze Name: 5x5
Maze Level: 1
0 1 1 1 1
8 0 0 1 0
1 1 0 1 3
0 0 0 0 0
0 1 0 1 1

Maze Name: 10x10
Maze Level: 2
0 1 1 1 1 1 0 1 0 1
8 0 0 0 0 0 0 1 0 0
0 1 1 1 1 1 0 1 1 0
0 1 0 0 0 0 0 0 0 0
0 1 0 1 1 1 1 1 0 1
0 0 0 1 3 0 0 0 0 0
1 1 0 1 1 1 0 1 1 1
1 0 0 0 0 0 0 1 0 0
1 0 1 1 1 0 1 1 0 1
1 0 0 0 0 0 0 0 0 0

